####################
#..................#
#..................#
#..CCC.....E.......#
#..................#
#..................#
#......AAA.........#
#......A.A....C....#
#......AAA.........#
#..................#
#..E...............#
#......@......C....#
#..................#
#..................#
####################