####################
#..................#
#..RRR...C.........#  
#..R.R.............#
#..RRR.....E.......#
#..................#
#......RRR.........#
#......R.R....C....#
#......RRR.........#
#..E...............#
#..................#
#......@...........#
#..................#
#........C....E....#
####################