####################
#..................#
#..C....FFFF.......#
#..###..F..F..E....#
#......FF..FF......#
#..................#
#..C...............#
#..##......FFF.....#
#..........F.F.....#
#..E.......FFF.....#
#..................#
#......@...........#
#..................#
#..E......C....E...#
####################