####################
#..................#
#..WWWW....C.......#
#..W..W............#
#..WWWW.....E......#
#..................#
#......WWWWW.......#
#......W...W..C....#
#......WWWWW.......#
#..................#
#..C...............#
#......@...........#
#..................#
#..E.......E.......#
####################